10 10 3 5
1111111111
1000000001
1010010001
1011110011
1000000101
1000101101
1011100001
1000001011
1010000011
1111111111